111111111111111111111111111111111111
1P00000000000000000000000C0000000001
1000100000000000N0000000000000000001
100000000000000001111000000010000001
100000000000001011111111000110000001
1000C0001000011000000001111100000001
1000N0000000110000C00000110000000001
100000000001100000000000000000000001
100000000011000111111000000000100001
10000000001000110000111000N000000001
100100000010011000000011000000000001
100000000110011000110001100000000001
1000000000000N0000111000100000001001
100000000110010000E01000100100000001
10CN00001110011000001000000000000001
100000001110000000011000100000000001
100000011010000111110000100000000001
10000011001100000000000110000000N001
1000001100011000N0000001000000C00001
100000000001111C00000011000000000001
100000111111111111111110000000000001
10C000000N00000000000000000000100001
100000000000000000C00000000000000001
111111111111111111111111111111111111